R        1000               900
NO       textures/bluestone.xpm
SO   textures/colorstone.xpm
WE                      textures/greystone.xpm
EA   textures/redbrick.xpm



S                         textures/barrel.xpm
F      220,     100,    0




C  225,    200,     0


    11111111111111111111111111111111111111111111111
111112000000000000000000000000000000000000000011111
    11222000000000000000000000000000000000000000001
    12000000000000000000000000000000000000000000001
    11120000000000000000000000000000000000000000011
    1220000000000000000000000000000000000000000001
    1200000000000000000000000000000000000000000001
    120000000000000000S000000000000000000000000001
    1222222222000000000000000000000000000000000001
    1200000000000000000000000000000000000000000001
    1222222222000000000000000000000000000000000011
    1200000000000000000000000000000000000000000001
    1200000000000000000000000000000000000000000001
    1200000000000000000000000000000000000000000001
    1200000000000000000000000000000000000000000001
    1200000000000000000000000000000000000000000001
    1200000000000100000100000000010000000000000001
    1120000000000000000000000000000000000000000011
    111200000000000000000000000000000000000000001
    120000000000100000000000000000000100000000011
    12000000000100000001100000000001100000000011
    1222222222122222221110000000001110000000011
    111111111111111111111111111111111111111111