R 1000 900
NO textures/bluestone.xpm
SO textures/colorstone.xpm
WE textures/greystone.xpm
EA textures/redbrick.xpm
S textures/barrel.xpm
F 220,100,0
C 225,200,0
 11111111111111111111
 122002200000000000001
 10000000000000000001
 120000000000000000001
 10000000000000000001
12000000000W000000001
10111000000000000001
101000000000000000001
10100000000000000001
11111111111111111111