R      1000 800
NO        textures/bluestone.xpm


SO textures/colorstone.xpm
WE textures/greystone.xpm


EA textures/redbrick.xpm
S           textures/barrel.xpm
F         220,100,0

C     225,30,0
111111111111111111
100001210000000001
100000000000200001
10000000000000001
11000000N00000011
1111111111100111111121
        100000000001222221100011
11111111100000000001
1000000012100000011
1111111111111111110001